011111111111111111111111111111111111111111
111111111111111111111111111111110000000110
000000000000000000000000000000110000000110
000000000000000000900000000000110000000110
011111111111111111111111111111110000000110
011000000000000000000000000000000000000110
011000000000000000900000000000000000000110
011000000000000000000000000000000000000110
011111111111111111111111111111110000000110
000000000000000000900000000000110000000110
000000000000000000000000000000111111111110
000000000000000000900009000000000000000000
