111111111111111111111111111111111111111111111111111111
222222222222222222222222222222222222222222222222222222
333333333333333333333333333333333333333333333333333333
111111111111111111111111111111111111111111111111111111
222222222222222222222222222222222222222222222222222222
333333333333333333333333333333333333333333333333333333
111111111111111111111111111111111111111111111111111111
222222222222222222222222222222222222222222222222222222
333333333333333333333333333333333333333333333333333333
111111111111111111111111111111111111111111111111111111
222222222222222222222222222222222222222222222222222222
333333333333333333333333333333333333333333333333333333
111111111111111111111111111111111111111111111111111111
222222222222222222222222222222222222222222222222222222
333333333333333333333333333333333333333333333333333333
111111111111111111111111111111111111111111111111111111
222222222222222222222222222222222222222222222222222222
333333333333333333333333333333333333333333333333333333