000000000000000000000000000000000000000000000000000000000
111111111111111111111111111111111111111111111111111111100
000000000000000000000000000000000000000000000000000001100
000011111111111111111111111111111111111111111111110001100
000011000000000000000000000000000000000000000000110001100
000011001111111111111111111111111111111111111000110001100
000011001100000000000000000000000000000000011000110001100
000011001103111100000000000000000000000000011000110001100
000011001100001111111111111111111111111111111000110001100
000011001100000000000000000000000000000000000000110001100
000011001111111111111111111111111111111111111111110001100
000011000000000000000000000000000000000000000000000001100
000011111111111111111111111111111111111111111111111111100
000000000000000000000000000000000000000000000000000000000
