000000000000000000000000000000000000000000
111111111111111111111111111111110000000110
000000000000000000000000000000110000000110
000000000000000000000000000000110000000110
071111111111111111111111111111110000000110
011000000000000000000000000000000000000110
011000000000000000000000000000000000000110
011000000000000000000000000000000000000110
011111111111111111111111111111110000000110
000000000000000000000000000000110000000110
000000000000000000000000000000111111111110
000000000000000000000000000000000000000000